5,2,1,5,0,0,2,5,1,1
4,3,3,5,0,0,0,0,3,4
2,5,5,2,1,9,1,4,1,1
2,1,3,3,5,5,0,0,3,1
0,0,8,5,9,4,4,1,4,1