1,1000,0,0,0,0,0,0,0,0
0,0,1,1000,0,0,0,0,0,0
0,0,0,0,1,1000,0,0,0,0
0,0,0,0,0,0,1,1000,0,0
0,0,0,0,0,0,0,0,1,1000
5,2000,1,5000,0,0000,2,5000,1,1000
4,3000,3,5000,0,0000,0,0000,3,4000
2,5000,5,2000,1,9000,1,4000,1,1000
2,1000,3,3000,5,5000,0,0000,3,1000
0,0,8,5000,9,4000,4,1000,4,1000